###########
#S   +   S#
#    +    #
#    +    #
#         #
#++++ ++++#
#         #
#    +    #
#    +    #
#S   +   S#
###########